#######
#.....#
#.###.#
#.#.#.#
#.#...#
#######